##################################################
#.......................F........................#
#................................................#
#................................................#
#................................................#
#................................................#
#................................................#
#................................................#
#................................................#
#................................................#
#................................................#
#.......................2........................#
#................................................#
#................................................#
#................................................#
#................................................#
#................................................#
#................................................#
#................................................#
#................................................#
#................................................#
#................................................#
#................................................#
#................................................#
#................................................#
#...G............................................#
#................................................#
#................................................#
#................................................#
#................................................#
#................................................#
#................................................#
#................................................#
#................................................#
#................................................#
#................................................#
#................................................#
#................................................#
#............................1...................#
#................................................#
#................................................#
#................................................#
#................................................#
#................................................#
#................................................#
#................................................#
#................................................#
#................................................#
#.......................E........................#
##################################################
