##################################################
#GGGGGGGGG......#...............#................#
#G.......G......#...............#................#
#.G..2...G............#.E.#......................#
#..G....G.............#...#......................#
#G.GG...G.......#####M.....M#####................#
#.GGGG.G.GG.............#.............GG.........#
#...GGGG.GG...........................GG.........#
#....GGG.........................................#
#.....GGG........................................#
#.......G........................................#
#................................................#
#................................................#
#................................................#
#...G.......G......G....M....G.......G.......G...#
#................................................#
#................................................#
#................................................#
#................................................#
#.........M.............G..............M.........#
#................................................#
#................................................#
#...GG........GG..................GG........GG...#
#...GG........GG..................GG........GG...#
#.........M.............M..............M.........#
#...GG........GG..................GG........GG...#
#...GG........GG..................GG........GG...#
#................................................#
#................................................#
#.........M.............G..............M.........#
#...MMMMMMMMMMMMMMMMMMMMMMMMMMMMMMMMMMMMMMMMMMM..#
#...M.........................................M..#
#...M........G.............G..................M..#
#...M......................GGGGGG.............M..#
#...M.....GG....................GGGGG.........M..#
#...M.....GGG...........1.....................M..#
#...M.......GG................................M..#
#...M........GG...................GG..........M..#
#...M.............................GGGGGG......M..#
#...M.........................................M..#
#...MMMMMMMMMMMMMMMMMMMMMMMMMMMMMMMMMMMMMMMMMMM..#
#........GG...........................GG.........#
#........GG.............#.............GG.........#
#...............#####.......#####................#
#.....................#...#......................#
#.....................#.F.#......................#
#...............#...............#................#
#...............#...............#................#
##################################################
